.............
.............
....@........
....@........
....@........
#####.#######
....#.#......
#####.#######
............#
............#
............#
............#
............#
............#
#############
