####################
##..@###############
##...#.....#########
##...#............##
##.........#.....@##
#######.####......##
#...#..@..........##
#..........#......##
#...#......#......##
#...################
#.............@.####
#...###########.####
##########........##
##########........##
##########........##
####################
